20 2 1
7 10
|X|---|+.-
#-||||---+
.-..-.|---
-.--..|---
--P.|P.F|-
P|-..P+-P|
--.-P....-
