30 5 10
6 8
........
.X-+-P..
.|.|.#..
.|.+-&.P
.+-+--F.
........