25 4 8
8 12
+---P----+..
|...|....|..
|.X-+..P.|..
|...|....|..
P...+----+..
|..........|
|....P....F|
+----------+
